10 10
ff........
ff........
..........
..........
..........
..........
..........
........h.
..........
s.........
